111111111111111111111111111111111111111
1E0000000000000000000000000000000000001
100000000000000000000001100000000000001
100000000000000000000001100000000000001
100000000C00000001100001111100000000001
100000000000000000000000000000000000001
100000000000000000000000000000000000001
100000000000000000000000001000000000001
100000000000000000000000001000000000001
100000000001111111000000001000000000001
100000000000000000000000001000000000001
10000000000000000100000011100000000C001
100000000000001001000000000000000000001
100000000000001111000000000000000000001
10000000001111111100C000000000000000001
10000000000000000C000000000000000000001
100000000000000000000000000000000000001
100000000000011111000000000000000000001
1000000000000000000000000000000C00000P1
111111111111111111111111111111111111111